*********************
*S*   * * * * *     *
* *** * * * * * *** *
*     *   *     *   *
* *** * * * * ***** *
*   * * *   *     * *
*** * ***** ***** ***
*   *   *   *       *
* * *** * * *** *** *
* * * *   * *     * *
*** * * * ********* *
* *   * * * *       *
* ******* * ***** ***
*   *       *   *   *
*** * *** ***** *****
*     *     *   * * *
*** ***** *** *** * *
*       *   * * *   *
* *** * *** * * * * *
*   * * * * *     * *
*** ***** * *** * ***
* * *           *   *
* * *** ******* * ***
* * * *   *   * *   *
* * * * *** *********
* * * *   *   * * * *
* * * ******* * * * *
*       * *       * *
*** *** * * * *** * *
* * *     * * *     *
* * ***** * *** *****
*   * *   * *       *
* *** *** * * * *** *
*     *     * *   * *
* *** *** ******* ***
*   *   * *   *     *
* ********* *** *****
* *             * * *
* * ***** *** *** * *
* *     * *        G*
*********************
