*****************************************
*S  *   *   *         * *   *           *
* ***** * *** ***** *** *** *** * *******
*   *   *   * * *     *   * * * * *   * *
*** *** *** *** *** *** *** * * *** * * *
* *       *                     *   * * *
* ***** *** * * *** *********** ***** * *
* *       * * *   * *   *   *       *   *
* * *** ***** ******* * * * ***** * * * *
* *   *       *   * * *   * *     * * * *
* * *** *** * *** * * ***** * * ***** * *
*   *     * * *   * *     *   *       * *
* *** ******* *** * * ***** ***** * *****
* * *   *   * *     *   *       * * *   *
* * *** *** * *** ************* *** * ***
*   *     * *     * *   *   *     *     *
* ***** * * *** *** * ***** ***** ***** *
*   * * *     *   *   *           *     *
***** *** ***** *** ********* *** * * ***
*           *   *               * * *  G*
*****************************************
