*****************************************
*   *         *     *       *     *    G*
* * * * * ***** * *** * ***** * * ***** *
* *   * *     * * *   *   *   * * * *   *
************* * * ******* ******* * *** *
*     * *       * *           * *     * *
*** * * *** ************* * *** ***** * *
*   *             * *   * *             *
***** * * ******* * * ***** * ***********
*     * *     * * * *       * * *   *   *
***** ***** *** *** * * ******* *** *** *
*     * *       *   * *   *     *   *   *
* *** * ********* * ***** ***** *** *** *
* *   *   *       *       * *     *   * *
* *** * * * * * ********* * * * *** * * *
*   * * *   * * * *           * *   *   *
* ******* ***** * ********* ***** *******
*       *   *   * *   *   * *   * * *   *
* * * ********* * *** * * * * *** * * * *
*S* *             *     *             * *
*****************************************
